;FUNCTION KEY DEFINITIONS FOR NEW-WORD WITH MDT-60
*WS.COM
UP	^E
~UP	^Z
^UP	^R
DOWN	^X
~DOWN	^W
^DOWN	^C
LEFT	^S
~LEFT	^A
^LEFT	^QS
RIGHT	^D
~RIGHT	^F
^RIGHT	^QD
F1	^U
~F1	^U
^F1	^U
F2	^KS
~F2	^KD
^F2	^KX
F3	^B
~F3	^QR^QB
^F3	^OJ
F4	^KB
~F4	^KV
^F4	^KW
F5	^KK
~F5	^KC
^F5	^KR
F6	^OG
~F6	^OL
^F6	^OR
F7	^QF
~F7	^QA
^F7	^L
F8	_DEL
~F8	^A^T
^F8	^Q_DEL
F9	^G
~F9	^T
^F9	^QY
ERASE	^Y
~ERASE	^KY
^ERASE	^KJ
~TAB	^OI
^TAB	^ON
HELP	^J
~HELP	^J^J3_RTN
^HELP	^J^J1_RTN
HOME	^QR
~HOME	^QC
^HOME	^KH
